background: 背景
tench: 丁鲷
goldfish: 金鱼
great white shark: 大白鲨
tiger shark: 虎鲨
hammerhead: 锤头鲨
electric ray: 电鳐
stingray: 黄貂鱼
cock: 公鸡
hen: 母鸡
ostrich: 鸵鸟
brambling: 燕雀
goldfinch: 金翅雀
house finch: 家朱雀
junco: 灯芯草雀
indigo bunting: 靛蓝雀,靛蓝鸟
robin: 蓝鹀
bulbul: 夜莺
jay: 松鸦
magpie: 喜鹊
chickadee: 山雀
water ouzel: 河鸟
kite: 鸢（猛禽）
bald eagle: 秃头鹰
vulture: 秃鹫
great grey owl: 大灰猫头鹰
European fire salamander: 欧洲火蝾螈
common newt: 普通蝾螈
eft: 水蜥
spotted salamander: 斑点蝾螈
axolotl: 蝾螈,泥狗
bullfrog: 牛蛙
tree frog: 树蛙
tailed frog: 尾蛙,铃蟾蜍,肋蟾蜍,尾蟾蜍
loggerhead: 红海龟
leatherback turtle: 皮革龟
mud turtle: 泥龟
terrapin: 淡水龟
box turtle: 箱龟
banded gecko: 带状壁虎
common iguana: 普通鬣蜥
American chameleon: 美国变色龙
whiptail: 鞭尾蜥蜴
agama: 飞龙科蜥蜴
frilled lizard: 褶边蜥蜴
alligator lizard: 鳄鱼蜥蜴
Gila monster: 毒蜥
green lizard: 绿蜥蜴
African chameleon: 非洲变色龙
Komodo dragon: 科莫多蜥蜴
African crocodile: 非洲鳄,尼罗河鳄鱼
American alligator: 美国鳄鱼,鳄鱼
triceratops: 三角龙
thunder snake: 雷蛇,蠕虫蛇
ringneck snake: 环蛇,环颈蛇
hognose snake: 希腊蛇
green snake: 绿蛇,草蛇
king snake: 国王蛇
garter snake: 袜带蛇,草蛇
water snake: 水蛇
vine snake: 藤蛇
night snake: 夜蛇
boa constrictor: 大蟒蛇
rock python: 岩石蟒蛇,岩蛇,蟒蛇
Indian cobra: 印度眼镜蛇
green mamba: 绿曼巴
sea snake: 海蛇
horned viper: 角腹蛇
diamondback: 菱纹响尾蛇
sidewinder: 角响尾蛇
trilobite: 三叶虫
harvestman: 盲蜘蛛
scorpion: 蝎子
black and gold garden spider: 黑金花园蜘蛛
barn spider: 谷仓蜘蛛
garden spider: 花园蜘蛛
black widow: 黑寡妇蜘蛛
tarantula: 狼蛛
wolf spider: 狼蜘蛛,狩猎蜘蛛
tick: 壁虱
centipede: 蜈蚣
black grouse: 黑松鸡
ptarmigan: 松鸡,雷鸟
ruffed grouse: 披肩鸡,披肩榛鸡
prairie chicken: 草原鸡,草原松鸡
peacock: 孔雀
quail: 鹌鹑
partridge: 鹧鸪
African grey: 非洲灰鹦鹉
macaw: 金刚鹦鹉
sulphur-crested cockatoo: 硫冠鹦鹉
lorikeet: 短尾鹦鹉
coucal: 褐翅鸦鹃
bee eater: 蜜蜂
hornbill: 犀鸟
hummingbird: 蜂鸟
jacamar: 鹟䴕
toucan: 犀鸟
drake: 野鸭
red-breasted merganser: 红胸秋沙鸭
goose: 鹅
black swan: 黑天鹅
tusker: 大象
echidna: 针鼹鼠
platypus: 鸭嘴兽
wallaby: 沙袋鼠
koala: 考拉,考拉熊
wombat: 袋熊
jellyfish: 水母
sea anemone: 海葵
brain coral: 脑珊瑚
flatworm: 扁形虫扁虫
nematode: 线虫,蛔虫
conch: 海螺
snail: 蜗牛
slug: 鼻涕虫
sea slug: 海参
chiton: 石鳖
chambered nautilus: 鹦鹉螺
Dungeness crab: 珍宝蟹
rock crab: 石蟹
fiddler crab: 招潮蟹
king crab: 帝王蟹,阿拉斯加蟹,阿拉斯加帝王蟹
American lobster: 美国龙虾,缅因州龙虾
spiny lobster: 大螯虾
crayfish: 小龙虾
hermit crab: 寄居蟹
isopod: 等足目动物(明虾和螃蟹近亲)
white stork: 白鹳
black stork: 黑鹳
spoonbill: 鹭
flamingo: 火烈鸟
little blue heron: 小蓝鹭
American egret: 美国鹭,大白鹭
bittern: 麻鸦
crane: 鹤
limpkin: 秧鹤
European gallinule: 欧洲水鸡,紫水鸡
American coot: 沼泽泥母鸡,水母鸡
bustard: 鸨
ruddy turnstone: 红翻石鹬
red-backed sandpiper: 红背鹬,黑腹滨鹬
redshank: 红脚鹬
dowitcher: 半蹼鹬
oystercatcher: 蛎鹬
pelican: 鹈鹕
king penguin: 国王企鹅
albatross: 信天翁,大海鸟
grey whale: 灰鲸
killer whale: 杀人鲸,逆戟鲸,虎鲸
dugong: 海牛
sea lion: 海狮
Chihuahua: 奇瓦瓦
Japanese spaniel: 日本猎犬
Maltese dog: 马尔济斯犬
Pekinese: 狮子狗
Shih-Tzu: 西施犬
Blenheim spaniel: 布莱尼姆猎犬
papillon: 巴比狗
toy terrier: 玩具犬
Rhodesian ridgeback: 罗得西亚长背猎狗
Afghan hound: 阿富汗猎犬
basset: 猎犬
beagle: 比格犬,猎兔犬
bloodhound: 侦探犬
bluetick: 蓝色快狗
black-and-tan coonhound: 黑褐猎浣熊犬
Walker hound: 沃克猎犬
English foxhound: 英国猎狐犬
redbone: 美洲赤狗
borzoi: 俄罗斯猎狼犬
Irish wolfhound: 爱尔兰猎狼犬
Italian greyhound: 意大利灰狗
whippet: 惠比特犬
Ibizan hound: 依比沙猎犬
Norwegian elkhound: 挪威猎犬
otterhound: 奥达猎犬,水獭猎犬
Saluki: 沙克犬,瞪羚猎犬
Scottish deerhound: 苏格兰猎鹿犬,猎鹿犬
Weimaraner: 威玛猎犬
Staffordshire bullterrier: 斯塔福德郡牛头㹴,斯塔福德郡斗牛㹴
American Staffordshire terrier: 美国斯塔福德郡㹴,美国比特斗牛㹴,斗牛㹴
Bedlington terrier: 贝德灵顿㹴
Border terrier: 边境㹴
Kerry blue terrier: 凯丽蓝㹴
Irish terrier: 爱尔兰㹴
Norfolk terrier: 诺福克㹴
Norwich terrier: 诺维奇㹴
Yorkshire terrier: 约克郡㹴
wire-haired fox terrier: 刚毛猎狐㹴
Lakeland terrier: 莱克兰㹴
Sealyham terrier: 锡利哈姆㹴
Airedale: 艾尔谷犬
cairn: 凯恩㹴
Australian terrier: 澳大利亚㹴
Dandie Dinmont: 丹迪丁蒙㹴
Boston bull: 波士顿㹴
miniature schnauzer: 迷你雪纳瑞犬
giant schnauzer: 巨型雪纳瑞犬
standard schnauzer: 标准雪纳瑞犬
Scotch terrier: 苏格兰㹴
Tibetan terrier: 西藏㹴,菊花狗
silky terrier: 丝毛㹴
soft-coated wheaten terrier: 软毛麦色㹴
West Highland white terrier: 西高地白㹴
Lhasa: 拉萨阿普索犬
flat-coated retriever: 平毛寻回犬
curly-coated retriever: 卷毛寻回犬
golden retriever: 金毛猎犬
Labrador retriever: 拉布拉多猎犬
Chesapeake Bay retriever: 乞沙比克猎犬
German short-haired pointer: 德国短毛猎犬
vizsla: 维兹拉犬
English setter: 英国谍犬
Irish setter: 爱尔兰雪达犬,红色猎犬
Gordon setter: 戈登雪达犬
Brittany spaniel: 布列塔尼犬猎犬
clumber: 黄毛,黄毛猎犬
English springer: 英国史宾格犬
Welsh springer spaniel: 威尔士史宾格犬
cocker spaniel: 可卡犬,英国可卡犬
Sussex spaniel: 萨塞克斯猎犬
Irish water spaniel: 爱尔兰水猎犬
kuvasz: 哥威斯犬
schipperke: 舒柏奇犬
groenendael: 比利时牧羊犬
malinois: 马里努阿犬
briard: 伯瑞犬
kelpie: 凯尔皮犬
komondor: 匈牙利牧羊犬
Old English sheepdog: 老英国牧羊犬
Shetland sheepdog: 喜乐蒂牧羊犬
collie: 牧羊犬
Border collie: 边境牧羊犬
Bouvier des Flandres: 法兰德斯牧牛狗
Rottweiler: 罗特韦尔犬
German shepherd: 德国牧羊犬,德国警犬,阿尔萨斯
Doberman: 多伯曼犬,杜宾犬
miniature pinscher: 迷你杜宾犬
Greater Swiss Mountain dog: 大瑞士山地犬
Bernese mountain dog: 伯恩山犬
Appenzeller: 阿彭泽勒狗
EntleBucher: 恩特雷布赫狗
boxer: 拳师狗
bull mastiff: 斗牛獒
Tibetan mastiff: 藏獒
French bulldog: 法国斗牛犬
Great Dane: 大丹犬
Saint Bernard: 圣伯纳德狗
Eskimo dog: 爱斯基摩犬,哈士奇
malamute: 雪橇犬,阿拉斯加爱斯基摩狗
Siberian husky: 哈士奇
dalmatian: 达尔马提亚,教练车狗
affenpinscher: 狮毛狗
basenji: 巴辛吉狗
pug: 哈巴狗,狮子狗
Leonberg: 莱昂贝格狗
Newfoundland: 纽芬兰岛狗
Great Pyrenees: 大白熊犬
Samoyed: 萨摩耶犬
Pomeranian: 博美犬
chow: 松狮,松狮
keeshond: 荷兰卷尾狮毛狗
Brabancon griffon: 布鲁塞尔格林芬犬
Pembroke: 彭布洛克威尔士科基犬
Cardigan: 威尔士柯基犬
toy poodle: 玩具贵宾犬
miniature poodle: 迷你贵宾犬
standard poodle: 标准贵宾犬
Mexican hairless: 墨西哥无毛犬
timber wolf: 灰狼
white wolf: 白狼,北极狼
red wolf: 红太狼,鬃狼,犬犬鲁弗斯
coyote: 狼,草原狼,刷狼,郊狼
dingo: 澳洲野狗,澳大利亚野犬
dhole: 豺
African hunting dog: 非洲猎犬,土狼犬
hyena: 鬣狗
red fox: 红狐狸
kit fox: 沙狐
Arctic fox: 北极狐狸,白狐狸
grey fox: 灰狐狸
tabby: 虎斑猫
tiger cat: 山猫,虎猫
Persian cat: 波斯猫
Siamese cat: 暹罗暹罗猫,
Egyptian cat: 埃及猫
cougar: 美洲狮,美洲豹
lynx: 猞猁,山猫
leopard: 豹子
snow leopard: 雪豹
jaguar: 美洲虎
lion: 狮子
tiger: 老虎
cheetah: 猎豹
brown bear: 棕熊
American black bear: 美洲黑熊
ice bear: 冰熊,北极熊
sloth bear: 懒熊
mongoose: 猫鼬
meerkat: 猫鼬,海猫
tiger beetle: 虎甲虫
ladybug: 瓢虫
ground beetle: 土鳖虫
long-horned beetle: 天牛
leaf beetle: 龟甲虫
dung beetle: 粪甲虫
rhinoceros beetle: 犀牛甲虫
weevil: 象甲
fly: 苍蝇
bee: 蜜蜂
ant: 蚂蚁
grasshopper: 蚱蜢
cricket: 蟋蟀
walking stick: 竹节虫
cockroach: 蟑螂
mantis: 螳螂
cicada: 蝉
leafhopper: 叶蝉
lacewing: 草蜻蛉
dragonfly: 蜻蜓
damselfly: 豆娘,蜻蛉
admiral: 优红蛱蝶
ringlet: 小环蝴蝶
monarch: 君主蝴蝶,大斑蝶
cabbage butterfly: 菜粉蝶
sulphur butterfly: 白蝴蝶
lycaenid: 灰蝶
starfish: 海星
sea urchin: 海胆
sea cucumber: 海参,海黄瓜
wood rabbit: 野兔
hare: 兔
Angora: 安哥拉兔
hamster: 仓鼠
porcupine: 刺猬,豪猪,
fox squirrel: 黑松鼠
marmot: 土拨鼠
beaver: 海狸
guinea pig: 豚鼠,豚鼠
sorrel: 栗色马
zebra: 斑马
hog: 猪
wild boar: 野猪
warthog: 疣猪
hippopotamus: 河马
ox: 牛
water buffalo: 水牛,亚洲水牛
bison: 野牛
ram: 公羊
bighorn: 大角羊,洛矶山大角羊
ibex: 山羊
hartebeest: 狷羚
impala: 黑斑羚
gazelle: 瞪羚
Arabian camel: 阿拉伯单峰骆驼,骆驼
llama: 骆驼
weasel: 黄鼠狼
mink: 水貂
polecat: 臭猫
black-footed ferret: 黑足鼬
otter: 水獭
skunk: 臭鼬,木猫
badger: 獾
armadillo: 犰狳
three-toed sloth: 树懒
orangutan: 猩猩,婆罗洲猩猩
gorilla: 大猩猩
chimpanzee: 黑猩猩
gibbon: 长臂猿
siamang: 合趾猿长臂猿,合趾猿
guenon: 长尾猴
patas: 赤猴
baboon: 狒狒
macaque: 恒河猴,猕猴
langur: 白头叶猴
colobus: 疣猴
proboscis monkey: 长鼻猴
marmoset: 狨（美洲产小型长尾猴）
capuchin: 卷尾猴
howler monkey: 吼猴
titi: 伶猴
spider monkey: 蜘蛛猴
squirrel monkey: 松鼠猴
Madagascar cat: 马达加斯加环尾狐猴,鼠狐猴
indri: 大狐猴,马达加斯加大狐猴
Indian elephant: 印度大象,亚洲象
African elephant: 非洲象,非洲象
lesser panda: 小熊猫
giant panda: 大熊猫
barracouta: 杖鱼
eel: 鳗鱼
coho: 银鲑,银鲑鱼
rock beauty: 三色刺蝶鱼
anemone fish: 海葵鱼
sturgeon: 鲟鱼
gar: 雀鳝
lionfish: 狮子鱼
puffer: 河豚
abacus: 算盘
abaya: 长袍
academic gown: 学位袍
accordion: 手风琴
acoustic guitar: 原声吉他
aircraft carrier: 航空母舰
airliner: 客机
airship: 飞艇
altar: 祭坛
ambulance: 救护车
amphibian: 水陆两用车
analog clock: 模拟时钟
apiary: 蜂房
apron: 围裙
ashcan: 垃圾桶
assault rifle: 攻击步枪,枪
backpack: 背包
bakery: 面包店,面包铺,
balance beam: 平衡木
balloon: 热气球
ballpoint: 圆珠笔
Band Aid: 创可贴
banjo: 班卓琴
bannister: 栏杆,楼梯扶手
barbell: 杠铃
barber chair: 理发师的椅子
barbershop: 理发店
barn: 牲口棚
barometer: 晴雨表
barrel: 圆筒
barrow: 园地小车,手推车
baseball: 棒球
basketball: 篮球
bassinet: 婴儿床
bassoon: 巴松管,低音管
bathing cap: 游泳帽
bath towel: 沐浴毛巾
bathtub: 浴缸,澡盆
beach wagon: 沙滩车,旅行车
beacon: 灯塔
beaker: 高脚杯
bearskin: 熊皮高帽
beer bottle: 啤酒瓶
beer glass: 啤酒杯
bell cote: 钟塔
bib: （小儿用的）围嘴
bicycle-built-for-two: 串联自行车,
bikini: 比基尼
binder: 装订册
binoculars: 双筒望远镜
birdhouse: 鸟舍
boathouse: 船库
bobsled: 雪橇
bolo tie: 饰扣式领带
bonnet: 阔边女帽
bookcase: 书橱
bookshop: 书店,书摊
bottlecap: 瓶盖
bow: 弓箭
bow tie: 蝴蝶结领结
brass: 铜制牌位
brassiere: 奶罩
breakwater: 防波堤,海堤
breastplate: 铠甲
broom: 扫帚
bucket: 桶
buckle: 扣环
bulletproof vest: 防弹背心
bullet train: 动车,子弹头列车
butcher shop: 肉铺,肉菜市场
cab: 出租车
caldron: 大锅
candle: 蜡烛
cannon: 大炮
canoe: 独木舟
can opener: 开瓶器,开罐器
cardigan: 开衫
car mirror: 车镜
carousel: 旋转木马
carpenter's kit: 木匠的工具包,工具包
carton: 纸箱
car wheel: 车轮
cash machine: 取款机,自动取款机
cassette: 盒式录音带
cassette player: 卡带播放器
castle: 城堡
catamaran: 双体船
CD player: CD播放器
cello: 大提琴
cellular telephone: 移动电话,手机
chain: 铁链
chainlink fence: 围栏
chain mail: 链甲
chain saw: 电锯,油锯
chest: 箱子
chiffonier: 衣柜,洗脸台
chime: 编钟,钟,锣
china cabinet: 中国橱柜
Christmas stocking: 圣诞袜
church: 教堂,教堂建筑
cinema: 电影院,剧场
cleaver: 切肉刀,菜刀
cliff dwelling: 悬崖屋
cloak: 斗篷
clog: 木屐,木鞋
cocktail shaker: 鸡尾酒调酒器
coffee mug: 咖啡杯
coffeepot: 咖啡壶
coil: 螺旋结构（楼梯）
combination lock: 组合锁
computer keyboard: 电脑键盘,键盘
confectionery: 糖果,糖果店
container ship: 集装箱船
convertible: 敞篷车
corkscrew: 开瓶器,瓶螺杆
cornet: 短号,喇叭
cowboy boot: 牛仔靴
cowboy hat: 牛仔帽
cradle: 摇篮
crane: 起重机
crash helmet: 头盔
crate: 板条箱
crib: 小儿床
Crock Pot: 砂锅
croquet ball: 槌球
crutch: 拐杖
cuirass: 胸甲
dam: 大坝,堤防
desk: 书桌
desktop computer: 台式电脑
dial telephone: 有线电话
diaper: 尿布湿
digital clock: 数字时钟
digital watch: 数字手表
dining table: 餐桌板
dishrag: 抹布
dishwasher: 洗碗机,洗碟机
disk brake: 盘式制动器
dock: 码头,船坞,码头设施
dogsled: 狗拉雪橇
dome: 圆顶
doormat: 门垫,垫子
drilling platform: 钻井平台,海上钻井
drum: 鼓,乐器,鼓膜
drumstick: 鼓槌
dumbbell: 哑铃
Dutch oven: 荷兰烤箱
electric fan: 电风扇,鼓风机
electric guitar: 电吉他
electric locomotive: 电力机车
entertainment center: 电视,电视柜
envelope: 信封
espresso maker: 浓缩咖啡机
face powder: 扑面粉
feather boa: 女用长围巾
file: 文件,文件柜,档案柜
fireboat: 消防船
fire engine: 消防车
fire screen: 火炉栏
flagpole: 旗杆
flute: 长笛
folding chair: 折叠椅
football helmet: 橄榄球头盔
forklift: 叉车
fountain: 喷泉
fountain pen: 钢笔
four-poster: 有四根帷柱的床
freight car: 运货车厢
French horn: 圆号,喇叭
frying pan: 煎锅
fur coat: 裘皮大衣
garbage truck: 垃圾车
gasmask: 防毒面具,呼吸器
gas pump: 汽油泵
goblet: 高脚杯
go-kart: 卡丁车
golf ball: 高尔夫球
golfcart: 高尔夫球车
gondola: 狭长小船
gong: 锣
gown: 礼服
grand piano: 钢琴
greenhouse: 温室,苗圃
grille: 散热器格栅
grocery store: 杂货店,食品市场
guillotine: 断头台
hair slide: 小发夹
hair spray: 头发喷雾
half track: 半履带装甲车
hammer: 锤子
hamper: 大篮子
hand blower: 手摇鼓风机,吹风机
hand-held computer: 手提电脑
handkerchief: 手帕
hard disc: 硬盘
harmonica: 口琴,口风琴
harp: 竖琴
harvester: 收割机
hatchet: 斧头
holster: 手枪皮套
home theater: 家庭影院
honeycomb: 蜂窝
hook: 钩爪
hoopskirt: 衬裙
horizontal bar: 单杠
horse cart: 马车
hourglass: 沙漏
phone: 手机
iron: 熨斗
jack-o'-lantern: 南瓜灯笼
jean: 牛仔裤,蓝色牛仔裤
jeep: 吉普车
jersey: 运动衫,T恤
jigsaw puzzle: 拼图
jinrikisha: 人力车
joystick: 操纵杆
kimono: 和服
knee pad: 护膝
knot: 蝴蝶结
lab coat: 大褂,实验室外套
ladle: 长柄勺
lampshade: 灯罩
laptop: 笔记本电脑
lawn mower: 割草机
lens cap: 镜头盖
letter opener: 开信刀,裁纸刀
library: 图书馆
lifeboat: 救生艇
lighter: 点火器,打火机
limousine: 豪华轿车
liner: 远洋班轮
lipstick: 唇膏,口红
Loafer: 平底便鞋
lotion: 洗剂
loudspeaker: 扬声器
loupe: 放大镜
lumbermill: 锯木厂
magnetic compass: 磁罗盘
mailbag: 邮袋
mailbox: 信箱
maillot: 女游泳衣
maillot: 有肩带浴衣
manhole cover: 窨井盖
maraca: 沙球（一种打击乐器）
marimba: 马林巴木琴
mask: 面膜
matchstick: 火柴
maypole: 花柱
maze: 迷宫
measuring cup: 量杯
medicine chest: 药箱
megalith: 巨石,巨石结构
microphone: 麦克风
microwave: 微波炉
military uniform: 军装
milk can: 奶桶
minibus: 迷你巴士
miniskirt: 迷你裙
minivan: 面包车
missile: 导弹
mitten: 连指手套
mixing bowl: 搅拌钵
mobile home: 活动房屋（由汽车拖拉的）
Model T: T型发动机小汽车
modem: 调制解调器
monastery: 修道院
monitor: 显示器
moped: 电瓶车
mortar: 砂浆
mortarboard: 学士
mosque: 清真寺
mosquito net: 蚊帐
motor scooter: 摩托车
mountain bike: 山地自行车
mountain tent: 登山帐
mouse: 鼠标,电脑鼠标
mousetrap: 捕鼠器
moving van: 搬家车
muzzle: 口套
nail: 钉子
neck brace: 颈托
necklace: 项链
nipple: 乳头（瓶）
notebook: 笔记本,笔记本电脑
obelisk: 方尖碑
oboe: 双簧管
ocarina: 陶笛,卵形笛
odometer: 里程表
oil filter: 滤油器
organ: 风琴,管风琴
oscilloscope: 示波器
overskirt: 罩裙
oxcart: 牛车
oxygen mask: 氧气面罩
packet: 包装
paddle: 船桨
paddlewheel: 明轮,桨轮
padlock: 挂锁,扣锁
paintbrush: 画笔
pajama: 睡衣
palace: 宫殿
panpipe: 排箫,鸣管
paper towel: 纸巾
parachute: 降落伞
parallel bars: 双杠
park bench: 公园长椅
parking meter: 停车收费表,停车计时器
passenger car: 客车,教练车
patio: 露台,阳台
pay-phone: 付费电话
pedestal: 基座,基脚
pencil box: 铅笔盒
pencil sharpener: 卷笔刀
perfume: 香水（瓶）
Petri dish: 培养皿
photocopier: 复印机
pick: 拨弦片,拨子
pickelhaube: 尖顶头盔
picket fence: 栅栏,栅栏
pickup: 皮卡,皮卡车
pier: 桥墩
piggy bank: 存钱罐
pill bottle: 药瓶
pillow: 枕头
ping-pong ball: 乒乓球
pinwheel: 风车
pirate: 海盗船
pitcher: 水罐
plane: 木工刨
planetarium: 天文馆
plastic bag: 塑料袋
plate rack: 板架
plow: 犁型铲雪机
plunger: 手压皮碗泵
Polaroid camera: 宝丽来相机
pole: 电线杆
police van: 警车,巡逻车
poncho: 雨披
pool table: 台球桌
pop bottle: 充气饮料瓶
pot: 花盆
potter's wheel: 陶工旋盘
power drill: 电钻
prayer rug: 祈祷垫,地毯
printer: 打印机
prison: 监狱
projectile: 炮弹,导弹
projector: 投影仪
puck: 冰球
punching bag: 沙包,吊球
purse: 钱包
quill: 羽管笔
quilt: 被子
racer: 赛车
racket: 球拍
radiator: 散热器
radio: 收音机
radio telescope: 射电望远镜,无线电反射器
rain barrel: 雨桶
recreational vehicle: 休闲车,房车
reel: 卷轴,卷筒
reflex camera: 反射式照相机
refrigerator: 冰箱,冰柜
remote control: 遥控器
restaurant: 餐厅,饮食店,食堂
revolver: 左轮手枪
rifle: 步枪
rocking chair: 摇椅
rotisserie: 电转烤肉架
rubber eraser: 橡皮
rugby ball: 橄榄球
rule: 直尺
running shoe: 跑步鞋
safe: 保险柜
safety pin: 安全别针
saltshaker: 盐瓶（调味用）
sandal: 凉鞋
sarong: 纱笼,围裙
sax: 萨克斯管
scabbard: 剑鞘
scale: 秤,称重机
school bus: 校车
schooner: 帆船
scoreboard: 记分牌
screen: 屏幕
screw: 螺丝
screwdriver: 螺丝刀
seat belt: 安全带
sewing machine: 缝纫机
shield: 盾牌,盾牌
shoe shop: 皮鞋店,鞋店
shoji: 障子
shopping basket: 购物篮
shopping cart: 购物车
shovel: 铁锹
shower cap: 浴帽
shower curtain: 浴帘
ski: 滑雪板
ski mask: 滑雪面罩
sleeping bag: 睡袋
slide rule: 滑尺
sliding door: 滑动门
slot: 角子老虎机
snorkel: 潜水通气管
snowmobile: 雪橇
snowplow: 扫雪机,扫雪机
soap dispenser: 皂液器
soccer ball: 足球
sock: 袜子
solar dish: 碟式太阳能,太阳能集热器,太阳能炉
sombrero: 宽边帽
soup bowl: 汤碗
space bar: 空格键
space heater: 空间加热器
space shuttle: 航天飞机
spatula: 铲（搅拌或涂敷用的）
speedboat: 快艇
spider web: 蜘蛛网
spindle: 纺锤,纱锭
sports car: 跑车
spotlight: 聚光灯
stage: 舞台
steam locomotive: 蒸汽机车
steel arch bridge: 钢拱桥
steel drum: 钢滚筒
stethoscope: 听诊器
stole: 女用披肩
stone wall: 石头墙
stopwatch: 秒表
stove: 火炉
strainer: 过滤器
streetcar: 有轨电车,电车
stretcher: 担架
studio couch: 沙发床
stupa: 佛塔
submarine: 潜艇,潜水艇
suit: 套装,衣服
sundial: 日晷
sunglass: 太阳镜
sunglasses: 太阳镜,墨镜
sunscreen: 防晒霜,防晒剂
suspension bridge: 悬索桥
swab: 拖把
sweatshirt: 运动衫
swimming trunks: 游泳裤
swing: 秋千
switch: 开关,电器开关
syringe: 注射器
table lamp: 台灯
tank: 坦克,装甲战车,装甲战斗车辆
tape player: 磁带播放器
teapot: 茶壶
teddy: 泰迪,泰迪熊
television: 电视
tennis ball: 网球
thatch: 茅草,茅草屋顶
theater curtain: 幕布,剧院的帷幕
thimble: 顶针
thresher: 脱粒机
throne: 宝座
tile roof: 瓦屋顶
toaster: 烤面包机
tobacco shop: 烟草店,烟草
toilet seat: 马桶
torch: 火炬
totem pole: 图腾柱
tow truck: 拖车,牵引车,清障车
toyshop: 玩具店
tractor: 拖拉机
trailer truck: 拖车,铰接式卡车
tray: 托盘
trench coat: 风衣
tricycle: 三轮车
trimaran: 三体船
tripod: 三脚架
triumphal arch: 凯旋门
trolleybus: 无轨电车
trombone: 长号
tub: 浴盆,浴缸
turnstile: 旋转式栅门
typewriter keyboard: 打字机键盘
umbrella: 伞
unicycle: 独轮车
upright: 直立式钢琴
vacuum: 真空吸尘器
vase: 花瓶
vault: 拱顶
velvet: 天鹅绒
vending machine: 自动售货机
vestment: 祭服
viaduct: 高架桥
violin: 小提琴,小提琴
volleyball: 排球
waffle iron: 松饼机
wall clock: 挂钟
wallet: 钱包,皮夹
wardrobe: 衣柜,壁橱
warplane: 军用飞机
washbasin: 洗脸盆,洗手盆
washer: 洗衣机,自动洗衣机
water bottle: 水瓶
water jug: 水壶
water tower: 水塔
whiskey jug: 威士忌壶
whistle: 哨子
wig: 假发
window screen: 纱窗
window shade: 百叶窗
Windsor tie: 温莎领带
wine bottle: 葡萄酒瓶
wing: 飞机翅膀,飞机
wok: 炒菜锅
wooden spoon: 木制的勺子
wool: 毛织品,羊绒
worm fence: 栅栏,围栏
wreck: 沉船
yawl: 双桅船
yurt: 蒙古包
web site: 网站,互联网网站
comic book: 漫画
crossword puzzle: 纵横字谜
street sign: 路标
traffic light: 交通信号灯
book jacket: 防尘罩,书皮
menu: 菜单
plate: 盘子
guacamole: 鳄梨酱
consomme: 清汤
hot pot: 罐焖土豆烧肉
trifle: 蛋糕
ice cream: 冰淇淋
ice lolly: 雪糕,冰棍,冰棒
French loaf: 法式面包
bagel: 百吉饼
pretzel: 椒盐脆饼
cheeseburger: 芝士汉堡
hotdog: 热狗
mashed potato: 土豆泥
head cabbage: 结球甘蓝
broccoli: 西兰花
cauliflower: 菜花
zucchini: 绿皮密生西葫芦
spaghetti squash: 西葫芦
acorn squash: 小青南瓜
butternut squash: 南瓜
cucumber: 黄瓜
artichoke: 朝鲜蓟
bell pepper: 甜椒
cardoon: 刺棘蓟
mushroom: 蘑菇
Granny Smith: 绿苹果
strawberry: 草莓
orange: 橘子
lemon: 柠檬
fig: 无花果
pineapple: 菠萝
banana: 香蕉
jackfruit: 菠萝蜜
custard apple: 蛋奶冻苹果
pomegranate: 石榴
hay: 干草
carbonara: 烤面条加干酪沙司
chocolate sauce: 巧克力酱,巧克力糖浆
dough: 面团
meat loaf: 瑞士肉包,肉饼
pizza: 披萨,披萨饼
potpie: 馅饼
burrito: 卷饼
red wine: 红葡萄酒
espresso: 意大利浓咖啡
cup: 杯子
eggnog: 蛋酒
alp: 高山
bubble: 泡泡
cliff: 悬崖
coral reef: 珊瑚礁
geyser: 间歇泉
lakeside: 湖边,湖岸
promontory: 海角
sandbar: 沙洲,沙坝
seashore: 海滨,海岸
valley: 峡谷
volcano: 火山
ballplayer: 棒球,棒球运动员
groom: 新郎
scuba diver: 潜水员
rapeseed: 油菜
daisy: 雏菊
yellow lady's slipper: 杓兰
corn: 玉米
acorn: 橡子
hip: 玫瑰果
buckeye: 七叶树果实
coral fungus: 珊瑚菌
agaric: 木耳
gyromitra: 鹿花菌
stinkhorn: 鬼笔菌
earthstar: 地星
hen-of-the-woods: 多叶奇果菌
bolete: 牛肝菌
ear: 玉米穗
toilet tissue: 卫生纸
